##################################################
#S....#.......#.........#.#.....................##
#####.#.#.#####.###.###.#.#.#####.#############.##
#.#...#.#...#.....#...#.#.#.....#.#...#...#...#.##
#.#.###.###.#.#######.#.#.#####.#.#.#.#.#.#.#.#.##
#...#.....#...#.......#.#...#...#.#.#...#...#...##
#.#######.#####.#######.#.###.###.#.##############
#.....#...#...#.....#.....#...#...#.#...........##
#####.###.###.#####.#.#####.###.###.#.#########.##
#...#...#.#.....#...#.#.....#.#.#.#...#.......#.##
#.#.###.#.#.###.#.#####.#####.#.#.###########.#.##
#.#...#.#...#...#.#.....#.#...#.#.............#.##
#.###.#.#####.###.#.#####.#.#.#.#.#####.###.###.##
#...#...#...#.#.#.#...#.....#.#.#.#.....#.#.#...##
###.#####.#.#.#.#.###.#.#####.#.#.#.#####.#.#.####
#.#...#...#.#...#...#.#...#...#.#.#.#...#...#...##
#.###.#####.###.###.#.#####.###.#.#.#.#.#.#####.##
#...#.#...#.#...#.#...#.....#...#.#.#.#.#.#.....##
#.###.#.#.#.#.###.#####.#####.###.#.#.#.#.#.######
#.#...#.#...#.#.........#.....#...#.#.#...#.#...##
#.#.###.###.#.#####.#.###.#####.###.#######.###.##
#.#...#...#.#.......#.#...#...#...#.........#...##
#.###.#.#.###########.#.#####.###.###########.#.##
#...#.#.#.#.....#.....#.....#...#.#...........#.##
###.#.###.#.###.#.#########.###.#.###.#######.#.##
#...#...#...#.#...#.....#...#...#...#.#.......#.##
#.#####.#.###.#########.#.###.#####.###.#######.##
#.#.....#.#.............#.#.......#.....#.....#.##
#.#.#####.#####.#######.#.#######.#######.###.#.##
#.#.....#.....#.#.#...#.#.#.........#.......#.#.##
#.#####.#####.#.#.#.#.#.#.#.#.#######.#######.#.##
#.....#.....#...#...#.#.#.#.#.#.......#.....#.#.##
#####.#####.#########.#.#.#.###.#######.###.#.#.##
#.....#...#.........#...#.#.....#.....#.#...#.#.##
#.###.#.###########.###.#.###.#######.#.#.###.#.##
#.#.#.#...........#...#.#...#.........#.#...#.#.##
#.#.#.###.###.#######.#.###.#####.#####.###.#.#.##
#.#...#...#...#.......#.#.#.#...#.#.....#.....#.##
#.#.###.#.#####.#######.#.#.#.#.#.#.###########.##
#.#...#.#.#.....#.....#...#.#.#...#.#.....#...#.##
#.###.#.#.#.#####.###.###.#.#.#####.#.###.#.#.#.##
#...#...#.#...#.....#...#.#.#.#...#...#.#.#.#...##
#.#.###.#####.#####.###.#.#.#.###.#####.#.#.######
#.#.#...#...#.....#...#...#.#...#...#...#.#.....##
###.#####.#.#####.#######.#.###.#.#.#.#.#.#####.##
#...#.....#.....#.......#.#...#...#.#.#.#...#...##
#.###.#########.#######.#####.#####.###.###.#.####
#.............#...............#...........#.....##
###############################################.G#
##################################################
